111111111111111111111111111111
101000000100000000000000010001
100000000100000000000000000101
100000000000000010000000011111
100000000100000000000000000001
100000000100000000000000000001
100000010000000100000000000001
111111111111111111111111111111
