1111111111111111111111111111111
1010000001000000000000000100001
1000000001000000000000000001001
1000000000000000100000000111111
1000000001000000000000000000001
1000000001000000000000000000001
1000000100000001000000000000001
1111111111111111111111111111111
