

NO textures/north.xpm


SO textures/south.xpm


WE textures/west.xpm


EA textures/east.xpm


F 150,15,15


C 30,50,255


11111111111111111111111111111111111111111111111111111111111111    1111111111111111111111
10000000000000000000000000000000000000000000000000000000000001    1000000000000000000001
10000000000000000000000000000000000000000000000000000000000001    1000000000000000000001
10000000000000000000000000000000000000000000000000000000000001    1000000000000000000001
10000000111111111111111111111110000000000000000000000000000001    1000000000000000000001
100000001                     10000000000000000000000000000001    1000000000000000000001
100000001                     10000000000000000000000000000001    1000000000000000000001
100000001                     10000000000000000000000000000001    1000000000000000000001     11111111111
100000001                     10000000000000000000000000000001    1000000000000000000001     100000000011
100000001                     10000000000000000000000000000001    1000000000000000000001     1011111110011
100000001                     10000000000000000000000000000001    100000000000000000000111111101     11001
100000001                     10000000000000000000000000000001    100000000000000000000000000001      1101
100000001                     10000000000000000000000000000001    100000000000000000000111111111       101
10000000111111111111111111111110000000000000000000000000000001    1000000000000000000001               101
10000000000000000000000000000000000000000000000000000000000001    1000000000000000000001               101
10000000000000000000000000000000000000000000000000000000000001    1000000000000000000001               101
10000000000000000000000000000000000000000000000000000000000001    1000000000000000000001               101
10000000000000000000000000000000000000000000000000000000000001    1000000000000000000001              1101
10000000000000000000000000000000000000000000000000000000000001    1000000000000000000001             11001
10000000000000000000000000000000000000000000000000000000000001    1000000000000000000001            110011
10000000000000000000000000000000001111111111111111111000000001    1000000000000000000001           110011
10000000000000000000000000000000001                 1000000001    1000000000000000000001          110011
10000000000000000000000000000000001                 1000000001    1000000000000000000001         110011
10000000000000000000000000000000001                 1000000001    1000000000000000000001        110011
10000000000000000000000000000000001                 1000000001    1000000000000000000001       110011
10000000000000000000000000000000001                 1000000001    1000000000000000000001      110011
10000000000000000000000000000000001                 1000000001    1000000000000000000001     110011
10000000000000000000000000000000001                 1000000011    1100000000000000000001    110011
10000000000000000000000000000000001                 100000001      100000000000000000001   110011
10000000000000000000000000000000001                 100000001      100000000000000000001  110011
10000000000000000000000000000000001111111111111111111000000011    1100000000000000000001 110011
100000000000000000000000000000000000000000000000000000000000011  11000000000000000000001110011
100000000000000000000000000000000000000000000000000000000000001111000000000000000000000110011
10000000000000000000000000000000000000000000000000000000000000000000000000000000000000000011
1000000000000000000000000000000000000000000000000000000000000000000000000000000000000001111
1000000000000000000000000000000000000000000000000000000000000000000000000000000000000001
1000000000000000000000000000000000000000000N00000000000000000000000000000000000000000001
1000000000000000000000000000000000000000000000000000000000000000000000000000000000000001
1000000000000000000000000000000000000000000000000000000000000000000000000000000000000001
1000000000000000000000000000000000000000000000000000000000000000000000000000000000000001
1000000000000000000000000000000000000000000000000000000000000000000000000000000000000001
1000000000000000000000000000000000000000000000000000000000000000000000000000000000000001
1111111111111111111111111111111111111111111111111111111111111111111111111111111111111111